NO ./textures/N.xpm   
SO ./textures/S.xpm
WE ./textures/W.xpm
EA ./textures/E.xpm

F 0,0,0
C 0,0,225

11111111111111111111111111111
10000000000000000000000000001
10111000000000000000000000001
101110N0000000000000000000001
10111000000000000000000000001
10000000000000000000000000001
10000000000000000000000000001
10000000000000000000000000001
10000000000000000000000000001
10000000000000000000000000001
10000000000000000000000000001
10000000000000000000000000001
10000000000000000000000000001
11111111111111111111111111111