NO ./textures/north.xpm   
SO ./textures/south.xpm
WE ./textures/west.xpm
EA ./textures/east.xpm

F 220,100,0
C 225,30,0

        111111111111111111111111
        1000000000000000000000001
        1000000000000000000010001
        1000000000000000000010001
111111111000000000000000000000001
100000000000000000000000000011111
10000000000000000000000000001
10000000000000000000000000001
10000000000000000000001000001
10000000000000000000000000001
10000000000000000000000000001
100000000000000000000000N0001
10000000000000000000000000001
11111111111111111111111111111