NO ./textures/N.xpm   
SO ./textures/S.xpm
WE ./textures/W.xpm
EA ./textures/E.xpm

F 0,0,0
C 0,0,225

        111111111111111111111111
        1000000000110000000000001
        1011000001110000000000001
        1001000000000000000000001
111111111011000001110000000000001
100000000011000001110111100011111
11110111111111011100000010001
111101 1111111011101010010001
11000111110101011100000010001
10000000000000001100000010001
10000000000000000001010000001
11000001110101011111011110N0011
11110111 1110101 101111010001
11111111 1111111 111111111111




111
1001
1111