NO ./textures/north.xpm   
SO ./textures/south.xpm
WE ./textures/west.xpm
EA ./textures/east.xpm

F 0,0,0
C 0,0,255

1111111
1000001            1111111111111111111111111
10000N11111111111111000100000000000000000011
10010000000000000000010000000000000000000001
10000011111111111111000100000000000000000001
1000001            1111111111111111111111111
1111111